76
26
0 0 0 0 0 0 0 0 0 0 0 4 0 0 0 0 0 0 0 0 0 0 0 0 0 0 0 0 0 0 0 0 0 0 4 0 0 0 0 0 0 0 0 0 0 0 0 0 0 0 0 0 0 0 0 0 0 21 21 21 21 21 21 21 21 21 21 21 21 21 21 21 21 21 21 21 
0 0 0 0 0 0 0 0 0 0 0 4 0 0 0 0 0 0 0 3 3 3 3 0 0 0 0 0 0 0 0 0 0 0 4 0 0 0 0 0 0 0 0 0 0 0 0 0 0 0 0 0 0 0 0 0 21 21 21 21 5 21 21 21 21 5 21 21 21 5 21 21 21 21 21 21 
0 0 0 0 0 0 0 0 0 0 0 4 0 0 0 0 0 0 0 21 21 21 21 0 0 0 0 0 0 0 0 0 0 0 4 0 0 0 0 0 0 0 0 0 0 0 0 0 0 0 0 0 0 0 0 0 0 21 21 5 5 5 21 21 21 21 21 21 21 21 21 21 21 21 21 21 
20 20 20 20 20 20 20 20 20 20 20 4 0 0 0 0 0 0 0 7 7 7 7 0 0 0 0 0 0 0 0 0 0 0 4 0 0 0 0 0 0 0 0 0 0 0 0 0 0 0 0 0 0 0 0 0 0 21 21 21 21 21 21 21 21 21 21 21 21 21 21 21 21 21 21 21 
22 22 22 22 22 22 22 22 22 22 22 4 0 0 0 0 0 0 0 0 0 0 0 0 0 0 0 0 0 0 0 0 0 0 4 0 0 0 0 0 0 0 0 0 0 0 0 0 0 0 0 0 0 0 0 0 0 21 21 21 21 21 21 21 21 5 21 21 21 21 21 21 21 21 21 21 
0 0 0 0 0 0 0 0 0 0 0 4 0 0 24 0 0 0 0 0 0 0 0 0 0 0 0 0 0 0 0 0 0 0 4 0 0 0 0 0 0 0 0 0 0 0 0 0 0 0 0 0 0 0 0 0 21 21 21 21 21 5 5 21 21 21 21 5 5 5 5 5 5 5 5 21 
0 0 0 0 0 0 0 0 0 0 0 4 0 0 0 0 0 0 25 0 0 0 0 25 0 0 0 0 0 0 0 0 0 0 4 0 0 0 0 0 0 0 0 0 0 0 0 0 0 0 0 0 0 0 0 21 21 21 21 21 21 5 5 21 21 21 21 5 5 5 5 5 5 5 5 21 
0 0 0 0 0 0 0 0 0 0 0 4 0 0 0 0 0 0 0 0 0 0 0 0 0 0 0 0 0 0 0 0 0 0 4 0 0 0 0 0 0 0 0 0 0 0 0 0 0 0 0 0 0 0 0 0 21 21 21 21 21 21 21 21 21 21 21 5 5 5 5 5 5 5 5 21 
0 0 0 0 0 0 0 0 0 0 0 4 0 0 0 0 0 0 0 3 3 3 0 0 0 0 0 23 23 23 0 0 0 0 4 0 3 3 3 0 0 0 0 0 0 0 0 0 0 0 0 0 0 0 0 0 0 21 21 21 21 21 21 21 21 21 21 5 5 5 5 5 5 5 5 21 
0 0 0 0 0 0 0 0 0 0 0 4 0 0 0 0 0 0 0 23 23 23 0 0 0 0 0 0 0 0 0 0 0 0 4 0 23 23 23 0 0 0 0 0 0 0 0 0 0 0 0 0 0 0 0 0 0 21 21 21 21 21 21 21 21 21 21 20 20 20 20 20 20 5 5 21 
0 0 0 0 0 0 0 0 0 0 0 4 0 0 0 0 0 0 0 0 0 0 0 0 0 0 0 0 0 0 0 0 0 0 4 0 0 0 0 0 0 0 0 0 0 0 0 0 0 0 0 0 0 0 0 0 0 21 21 21 21 21 21 21 5 5 5 21 21 21 21 21 21 5 5 21 
0 0 0 0 0 0 0 0 0 0 0 4 0 0 0 0 0 0 0 0 0 0 0 0 0 1 20 20 20 20 20 20 2 0 4 0 0 0 0 0 0 0 0 0 0 0 0 0 0 0 0 0 0 0 0 0 0 21 0 21 21 0 21 21 21 21 21 21 21 21 5 21 21 5 21 21 
0 0 0 0 0 0 0 0 0 0 0 4 0 0 0 0 0 0 0 0 0 0 0 0 0 0 21 21 21 21 21 21 0 0 4 0 0 0 0 0 0 0 0 0 0 0 0 0 0 0 0 0 0 0 0 0 0 0 0 0 0 0 0 0 0 0 0 0 5 5 5 5 5 5 5 21 
0 0 0 0 0 0 0 0 0 0 0 4 0 0 0 0 0 0 0 0 0 0 0 0 0 0 22 22 22 22 22 22 0 24 4 0 0 0 20 20 20 20 0 0 0 0 0 3 3 3 3 3 3 3 3 3 3 0 0 0 0 0 0 0 0 0 0 0 5 5 5 5 5 5 5 21 
0 0 0 0 0 0 0 0 0 0 0 4 0 0 0 0 0 0 0 0 0 0 0 0 0 0 0 0 0 0 0 0 0 0 4 0 0 0 0 0 0 0 0 0 0 0 0 20 20 20 20 21 21 21 21 21 21 0 0 0 0 0 0 0 0 0 0 0 20 20 20 20 20 20 20 21 
0 0 0 0 0 0 0 0 0 0 0 4 0 0 0 0 0 0 0 0 0 0 0 0 0 0 0 0 0 0 0 0 0 0 4 0 0 0 0 0 0 0 0 0 0 0 0 21 21 5 21 21 21 21 21 21 21 0 0 0 0 0 0 0 0 0 0 0 21 21 21 21 21 21 21 21 
0 0 0 0 0 0 0 0 0 0 0 4 0 0 0 0 0 0 0 0 0 0 0 0 0 0 0 0 0 0 0 0 0 0 4 0 0 0 0 0 0 0 0 0 0 0 24 21 21 21 21 21 21 21 21 21 21 20 20 6 0 0 0 20 20 20 20 20 21 21 21 21 21 21 21 21 
3 3 3 3 3 3 0 0 0 0 0 4 0 0 0 0 0 0 0 0 0 0 0 0 0 0 0 0 0 0 0 0 0 0 4 0 0 0 0 0 0 0 0 0 0 0 7 21 21 21 21 21 21 21 21 21 21 22 22 0 0 0 0 22 22 22 22 22 22 22 22 22 22 22 22 21 
20 20 20 20 20 20 0 0 0 0 0 4 0 0 0 0 0 0 0 0 0 0 0 0 0 0 0 0 0 0 0 0 0 0 4 0 0 0 0 0 1 23 23 2 0 0 3 21 21 21 21 21 21 21 21 21 21 0 0 0 24 0 0 0 0 0 0 0 0 0 0 0 0 0 0 21 
21 21 21 21 21 21 0 0 0 0 0 4 0 0 0 0 0 0 0 0 0 0 0 0 0 0 0 0 0 0 0 0 0 0 4 0 0 0 0 0 0 0 0 0 0 0 20 21 21 21 5 21 21 21 21 21 21 0 0 0 0 0 0 0 0 0 0 0 0 0 0 0 0 0 0 21 
21 5 21 21 5 21 0 0 0 0 0 4 0 0 0 0 0 24 0 0 0 0 0 0 0 0 0 0 0 0 0 0 0 0 4 0 0 0 0 0 0 0 0 0 0 20 21 21 21 21 21 21 21 21 21 21 21 3 3 0 3 3 3 3 0 0 3 3 0 0 0 0 0 0 0 21 
21 21 21 21 21 21 0 0 0 0 0 4 0 0 0 0 0 24 0 0 25 0 0 0 0 0 0 0 0 0 0 0 0 0 4 0 0 0 0 0 0 0 0 0 0 21 21 21 21 21 21 21 21 21 21 21 21 20 20 20 20 20 20 20 20 20 20 20 20 20 20 20 2 0 0 21 
21 21 5 21 21 21 20 0 0 0 0 4 0 25 0 0 0 24 25 24 24 0 0 0 0 0 0 0 0 0 0 0 0 0 4 0 0 0 20 20 20 20 20 20 20 20 20 20 20 20 20 20 20 5 5 5 21 5 5 5 5 5 5 5 5 5 5 5 5 5 5 5 0 0 25 21 
5 21 21 21 5 21 21 20 20 20 20 20 20 20 20 20 20 20 20 20 20 20 20 20 20 20 20 0 0 0 0 0 0 0 4 0 0 20 21 21 21 21 21 21 21 21 21 21 21 21 21 21 5 5 5 5 21 5 5 5 5 5 5 5 5 5 5 5 5 5 5 5 0 0 0 21 
21 21 21 21 21 21 21 21 21 21 21 21 21 21 21 21 21 21 21 21 21 5 21 21 21 21 21 3 3 3 3 21 21 21 21 21 21 21 21 21 21 21 21 21 21 5 21 21 21 21 21 21 5 5 5 5 24 5 5 5 5 5 5 5 5 5 5 5 5 5 5 5 0 0 0 21 
22 22 22 22 22 22 22 22 22 22 22 22 22 22 22 22 22 22 22 22 22 22 22 22 22 22 22 22 22 22 22 22 22 22 22 22 22 22 22 22 22 22 22 22 22 22 22 22 22 22 22 22 22 22 22 22 22 22 22 22 22 22 22 22 22 22 22 22 22 22 22 22 22 22 22 22 
