25
22
0 0 0 0 0 0 0 0 4 0 0 0 0 5 0 0 0 0 0 4 0 0 0 0 0 
0 5 0 0 5 0 0 0 4 0 0 0 0 0 0 0 0 0 0 4 0 0 0 0 0 
0 0 0 0 0 0 5 0 4 0 0 0 0 0 0 5 0 0 0 4 0 0 0 0 0 
0 0 0 0 0 0 0 0 4 0 0 0 0 0 0 0 0 0 0 4 0 0 0 5 0 
20 20 20 20 20 20 20 20 20 20 20 20 2 0 0 0 0 0 0 4 0 0 0 0 0 
21 21 21 21 21 21 22 22 22 22 22 22 0 0 0 0 0 0 0 4 0 0 0 0 0 
22 22 22 22 22 22 0 0 4 0 0 0 0 0 0 3 3 3 24 25 3 3 3 0 0 
0 5 0 0 0 5 0 0 4 0 0 0 0 0 1 20 20 20 20 20 20 20 20 2 0 
0 0 0 0 0 0 0 0 4 0 0 0 0 0 0 21 21 21 21 21 21 21 21 0 0 
0 0 25 0 0 0 0 0 4 0 0 0 5 0 0 22 22 22 22 22 22 22 22 0 0 
1 23 23 23 2 0 0 0 4 0 0 0 0 0 0 0 0 0 0 4 0 0 0 0 0 
0 0 0 0 0 0 0 0 4 0 0 0 0 0 0 0 0 0 0 4 0 0 0 0 0 
0 0 0 0 0 0 5 0 4 0 0 0 0 0 0 0 0 0 0 4 0 0 0 0 0 
0 0 0 0 0 0 0 0 4 0 0 0 0 0 0 0 0 0 0 4 0 0 0 0 0 
0 0 0 0 0 0 0 0 4 0 0 0 0 0 0 0 0 0 0 4 0 0 0 0 0 
0 0 0 0 0 0 0 0 4 0 0 0 0 0 0 0 0 0 0 4 0 0 0 0 0 
0 5 0 0 0 0 0 0 4 0 0 0 0 0 0 0 0 0 0 4 0 0 0 5 0 
0 0 0 0 0 0 0 0 4 0 0 0 0 0 0 0 0 0 0 4 0 0 0 0 0 
0 0 0 0 0 0 0 0 4 0 0 0 5 0 0 0 0 0 0 4 0 0 0 0 0 
0 0 0 0 0 0 0 0 4 0 0 0 0 0 0 0 0 0 0 4 0 0 0 0 0 
0 0 0 0 0 0 0 0 4 0 0 0 0 0 0 0 0 0 0 4 0 0 0 0 0 
0 0 0 0 0 0 0 0 4 0 0 0 0 0 0 0 0 0 0 4 0 0 0 0 0 
