40
69
21 21 21 21 21 21 21 21 21 21 21 21 21 21 21 21 21 21 20 20 20 21 21 21 21 21 21 21 21 21 21 21 21 21 21 21 21 21 21 21 
21 0 0 0 0 0 0 0 0 0 0 0 0 0 21 21 21 21 21 21 21 21 21 21 20 0 0 0 0 0 0 0 0 0 0 0 0 0 0 21 
21 0 0 0 0 0 0 0 0 0 0 0 0 0 20 21 21 21 21 21 21 21 21 21 20 0 0 0 0 0 0 0 0 0 0 0 0 0 0 21 
21 0 0 0 0 0 0 0 0 0 0 0 0 0 20 21 21 21 21 21 21 21 21 21 20 0 0 0 0 0 0 0 0 0 0 0 0 0 0 21 
21 0 0 0 0 0 0 0 0 0 0 0 0 0 20 21 21 21 21 21 21 21 21 21 20 0 0 0 0 0 0 0 0 0 0 0 0 0 0 21 
21 0 0 0 0 0 0 0 0 0 0 0 0 0 20 21 21 21 21 21 21 21 21 21 20 0 0 0 0 0 0 0 0 0 0 0 0 0 0 21 
21 0 0 0 0 0 0 0 0 0 0 0 0 0 20 21 21 21 21 21 21 21 21 21 20 0 0 0 0 0 0 0 0 0 0 0 0 0 0 21 
21 0 0 0 0 0 0 0 0 0 0 0 0 0 20 21 21 21 21 21 21 21 21 21 20 0 0 0 0 0 0 0 0 0 0 0 0 0 0 21 
21 0 0 0 0 0 0 0 0 0 0 0 0 0 20 21 21 21 21 21 21 21 21 21 20 0 0 0 0 0 0 0 0 0 0 0 0 0 0 21 
21 0 0 0 0 0 0 0 0 0 0 0 0 0 20 21 21 21 21 21 21 21 21 21 20 0 0 0 0 0 0 0 0 0 0 0 0 0 0 21 
21 0 0 0 0 0 0 0 0 0 0 0 0 0 20 21 21 21 21 21 21 21 21 21 20 0 0 0 0 0 0 0 0 0 0 0 0 0 0 21 
21 0 0 0 0 0 0 0 0 0 0 0 0 0 20 21 21 21 21 21 21 21 21 21 20 0 0 0 0 0 0 0 0 0 0 0 0 0 0 21 
21 0 0 0 0 0 0 0 0 0 0 0 0 0 20 21 21 21 21 21 21 21 21 21 20 0 0 0 0 0 0 0 0 0 0 0 0 0 0 21 
21 0 0 0 0 0 0 0 0 0 0 0 0 0 20 21 21 21 21 21 21 21 21 21 20 0 0 0 0 0 0 0 0 0 0 0 0 0 0 21 
21 0 0 0 0 0 0 0 0 0 0 0 0 0 20 21 21 21 21 21 21 21 21 21 20 0 0 0 0 0 0 0 0 0 0 0 0 0 0 21 
21 0 0 0 0 0 0 0 0 0 0 0 0 0 20 21 21 21 21 21 21 21 21 21 20 0 0 0 0 0 0 0 0 0 0 0 0 0 0 21 
21 0 0 0 0 0 0 0 0 0 0 0 0 0 20 21 21 21 21 21 21 21 21 21 20 0 0 0 0 0 0 0 0 0 0 0 0 0 0 21 
21 0 0 0 0 0 0 0 0 0 0 0 0 0 20 21 21 21 21 21 21 21 21 21 20 0 0 0 0 0 0 0 0 0 0 0 0 0 0 21 
21 0 0 0 0 0 0 0 0 0 0 0 0 0 20 21 21 21 21 21 21 21 21 21 20 0 0 0 0 0 0 0 0 0 0 0 0 0 0 21 
21 0 0 0 0 0 0 0 0 0 0 0 0 0 20 21 21 21 21 21 21 21 21 21 20 0 0 0 0 0 0 0 0 0 0 0 0 0 0 21 
21 0 0 0 0 0 0 0 0 0 0 0 0 0 20 21 21 21 21 21 21 21 21 21 21 0 0 0 0 0 0 0 0 0 0 0 0 0 0 21 
21 0 0 0 0 0 0 0 0 0 0 0 0 0 20 21 21 21 21 21 21 21 21 21 21 0 0 0 0 0 0 0 0 0 0 0 0 0 0 21 
21 0 0 0 0 0 0 0 0 0 0 0 0 0 20 21 21 21 21 21 21 21 21 21 21 0 0 0 0 0 0 0 0 0 0 0 0 0 0 21 
21 0 0 0 0 0 0 0 0 0 0 0 0 0 20 21 21 21 21 21 21 21 21 21 21 0 0 0 0 0 0 0 0 0 0 0 0 0 0 21 
21 0 0 0 0 0 0 0 0 0 0 0 0 0 20 20 20 20 20 20 20 20 20 20 20 0 0 0 0 0 0 0 0 0 0 0 0 0 0 21 
21 0 0 0 0 0 0 0 0 0 0 0 0 0 20 20 20 20 20 20 20 20 20 20 20 0 0 0 0 0 0 0 0 0 0 0 0 0 0 21 
21 0 0 0 0 0 0 0 0 0 0 0 0 0 20 20 20 20 20 20 20 20 20 20 20 0 0 0 0 0 0 0 0 0 0 0 0 0 0 21 
21 0 0 0 0 0 0 0 0 0 0 0 0 0 20 20 20 20 20 20 20 20 20 20 20 0 0 0 0 0 0 0 0 0 0 0 0 0 0 21 
21 0 0 0 0 0 0 0 0 0 0 0 0 0 20 20 20 20 20 20 20 20 20 20 20 0 0 0 0 0 0 0 0 0 0 0 0 0 0 21 
21 0 0 0 0 0 0 0 0 0 0 0 0 0 20 20 20 20 20 20 20 20 20 20 20 0 0 0 0 0 0 0 0 0 0 0 0 0 0 21 
21 0 0 0 0 0 0 0 0 0 0 0 0 0 20 20 20 20 20 20 20 20 20 20 20 0 0 0 0 0 0 0 0 0 0 0 0 0 0 21 
21 0 0 0 0 0 0 0 0 0 0 0 0 0 20 20 20 20 20 20 20 20 20 20 20 0 0 0 0 0 0 0 0 0 0 0 0 0 0 21 
21 0 0 0 0 0 0 0 0 0 0 0 0 0 20 20 20 20 20 20 20 20 20 20 20 0 0 0 0 0 0 0 0 0 0 0 0 0 0 21 
21 0 0 0 0 0 0 0 0 0 0 0 0 0 20 20 20 20 20 20 20 20 20 20 20 0 0 0 0 0 0 0 0 0 0 0 0 0 0 21 
21 0 0 0 0 0 0 0 0 0 0 0 0 0 20 20 20 20 20 20 20 20 20 20 20 0 0 0 0 0 0 0 0 0 0 0 0 0 0 21 
21 0 0 0 0 0 0 0 0 0 0 0 0 0 20 20 20 20 20 20 20 20 20 20 20 0 0 0 0 0 0 0 0 0 0 0 0 0 0 21 
21 0 0 0 0 0 0 0 0 0 0 0 0 0 20 20 20 20 20 20 20 20 20 20 20 0 0 0 0 0 0 0 0 0 0 0 0 0 0 21 
21 0 0 0 0 0 0 0 0 0 0 0 0 0 20 20 20 20 20 20 20 20 20 20 20 0 0 0 0 0 0 0 0 0 0 0 0 0 0 21 
21 0 0 0 0 0 0 0 0 0 0 0 0 0 20 20 20 20 20 20 20 20 20 20 20 0 0 0 0 0 0 0 0 0 0 0 0 0 0 21 
21 0 0 0 0 0 0 0 0 0 0 0 0 0 20 20 20 20 20 20 20 20 20 20 20 0 0 0 0 0 0 0 0 0 0 0 0 0 0 21 
21 0 0 0 0 0 0 0 0 0 0 0 0 0 20 20 20 20 20 20 20 20 20 20 20 0 0 0 0 0 0 0 0 0 0 0 0 0 0 21 
21 0 0 0 0 0 0 0 0 0 0 0 0 0 20 20 20 20 20 20 20 20 20 20 20 0 0 0 0 0 0 0 0 0 0 0 0 0 0 21 
21 0 0 0 0 0 0 0 0 0 0 0 0 0 20 20 20 20 20 20 20 20 20 20 20 0 0 0 0 0 0 0 0 0 0 0 0 0 0 21 
21 0 0 0 0 0 0 0 0 0 0 0 0 0 20 20 20 20 20 20 20 20 20 20 20 0 0 0 0 0 0 0 0 0 0 0 0 0 0 21 
21 0 0 0 0 0 0 0 0 0 0 0 0 0 20 20 20 20 20 20 20 20 20 20 20 0 0 0 0 0 0 0 0 0 0 0 0 4 0 21 
21 0 0 0 0 0 0 0 0 0 0 0 0 0 20 20 20 20 20 20 20 20 20 20 20 0 0 0 0 3 3 0 0 0 0 3 3 4 0 21 
21 20 0 0 0 0 0 0 0 0 0 0 0 0 20 20 20 20 20 20 20 20 20 20 20 0 0 20 20 20 20 20 20 20 20 20 20 20 20 21 
21 0 0 0 0 0 0 0 0 0 0 0 0 0 20 20 20 20 20 20 20 20 20 20 20 0 0 0 4 0 0 0 0 0 4 0 0 0 0 21 
21 0 0 0 0 0 0 0 0 0 0 0 0 0 20 20 20 20 20 20 20 20 20 20 20 0 0 0 4 0 0 0 0 0 4 0 0 0 0 21 
21 0 0 0 0 0 0 0 0 0 0 0 0 0 20 20 20 20 20 20 20 20 20 20 20 0 24 6 4 0 0 0 0 0 4 0 0 0 0 21 
21 0 0 0 0 0 0 0 0 0 0 0 0 0 20 20 20 20 20 20 20 20 20 20 20 0 7 0 4 25 25 8 24 0 4 0 0 0 0 21 
21 0 0 8 24 6 0 0 0 0 0 0 0 0 20 21 21 21 21 21 21 21 21 21 20 0 0 0 4 0 0 0 7 0 4 0 0 0 0 21 
21 0 0 0 0 0 0 0 0 0 0 0 0 0 20 21 21 21 21 21 21 21 21 21 20 0 0 0 4 0 0 0 0 0 4 0 0 0 0 21 
21 0 0 0 0 0 0 0 0 0 0 0 0 0 20 21 21 21 21 21 21 21 21 21 20 0 24 0 4 0 24 0 0 0 24 0 0 0 0 21 
21 20 20 20 20 20 20 0 0 0 0 0 0 20 20 21 21 21 21 21 21 21 21 21 20 0 0 0 4 0 0 0 0 0 4 0 0 0 0 21 
21 0 0 0 0 0 0 0 0 0 0 0 0 0 21 21 21 21 21 21 21 21 21 21 20 0 0 0 4 0 0 0 0 0 4 0 0 0 0 21 
21 0 0 0 0 0 0 0 0 0 0 0 0 0 21 21 21 21 21 21 21 21 21 21 20 24 0 0 4 0 0 0 0 0 4 0 0 0 0 21 
21 0 0 0 0 0 25 0 0 0 0 0 0 3 21 21 21 21 21 21 21 21 21 21 20 0 0 0 4 0 0 0 0 0 4 0 0 0 0 21 
21 0 0 0 0 0 0 0 0 0 0 0 0 23 21 21 21 21 21 21 21 21 21 21 20 0 0 3 4 3 3 0 0 0 4 0 0 0 0 21 
21 0 0 0 0 0 0 0 0 0 0 0 0 0 21 21 21 21 21 21 21 21 21 21 21 20 20 20 20 20 20 20 3 3 4 0 0 0 0 21 
21 0 0 0 0 0 0 0 0 24 0 0 0 0 0 0 0 0 0 0 0 0 0 0 0 0 0 0 4 0 0 21 20 20 20 0 0 0 0 21 
21 0 0 0 0 0 0 0 0 0 0 0 0 0 0 0 0 0 0 0 0 0 0 0 0 0 0 0 4 0 0 4 0 0 4 0 0 0 0 21 
21 0 0 0 0 0 0 0 0 0 0 0 0 0 3 3 0 3 3 0 3 3 3 0 3 0 0 0 4 0 0 4 0 0 4 0 0 0 0 21 
21 23 23 23 23 23 23 2 0 0 0 0 0 0 21 21 21 21 21 21 21 21 21 21 21 0 0 0 4 0 0 4 0 0 4 0 0 0 25 21 
21 0 0 0 0 0 0 0 0 0 0 0 1 23 21 21 21 21 21 21 21 21 21 21 21 0 0 0 4 0 0 4 0 0 4 0 0 0 0 21 
21 0 0 0 0 0 0 0 0 0 0 0 0 0 21 21 21 21 21 21 21 21 21 21 21 3 3 0 4 0 3 4 3 3 4 3 3 0 0 21 
21 20 20 20 20 20 20 20 20 20 20 20 20 20 21 21 21 21 21 21 21 21 21 21 21 20 20 20 20 20 20 20 20 20 20 20 20 20 20 21 
21 21 21 21 21 21 21 21 21 21 21 21 21 21 21 21 21 21 21 21 21 21 21 21 21 21 21 21 21 21 21 21 21 21 21 20 21 21 21 21 
22 22 22 22 22 22 22 22 22 22 22 22 22 22 22 22 22 22 22 22 22 22 22 22 22 22 22 22 22 22 22 22 22 22 22 22 22 22 22 22 
